111111
100P11
100001
1E00C1
10C001
111111