111111111111
10P10C010C00
10C00000C001
1E000000C001
10C00000C001
111111111111